[Europa]
Albania=Tirana
Alemania=Berlín
Andorra=Andorra la Vieja
Austria=Viena
Bélgica=Bruselas
Bielorrusia=Minsk
Bosnia-Herzegovina=Sarajevo
Bulgaria=Sofía
República Checa=Praga
Croacia=Zagreb
Dinamarca=Copenhague
Eslovaquia=Bratislava
Eslovenia=Liubliana
España=Madrid
Estonia=Tallin
Finlandia=Helsinki
Francia=París
Grecia=Atenas
Hungría=Budapest
Irlanda=Dublín
Islandia=Reikiavik
Italia=Roma
Letonia=Riga
Liechtenstein=Vaduz
Lituania=Vilna
Luxemburgo=Luxemburgo
Macedonia=Skopie
Malta=La Valeta
Moldavia=Chisinau
Mónaco=Mónaco
Noruega=Oslo
Países Bajos=Ámsterdam
(Holanda)
Polonia=Varsovia
Portugal=Lisboa
Reino Unido=Londres
(Reino Unido de Gran Bretaña e Irlanda del Norte)
Rumanía=Bucarest
Rusia=Moscú
San Marino=San Marino
Estado de la Ciudad del Vaticano=Ciudad del Vaticano
Suecia=Estocolmo
Suiza=Berna
Turquía=Ankara
Ucrania=Kiev
Serbia y Montenegro=Belgrado
(Sealand)

[América]
Antigua y Barbuda=Saint John
Argentina=Buenos Aires
Bahamas=Nassau
Barbados=Bridgetown
Belice=Belmopán
Bolivia=Sucre
(La Paz es la sede del gobierno)
Brasil=Brasilia
Canadá=Ottawa
Chile=Santiago de Chile
Colombia=Bogotá
Costa Rica=San José
Cuba=La Habana
Dominica=Roseau
Ecuador=Quito
El Salvador=San Salvador
Estados Unidos de América=Washington D. C.
Granada=Saint George
Guatemala=Ciudad de Guatemala
Guyana=Georgetown
Haití=Puerto Príncipe
Honduras=Tegucigalpa
Jamaica=Kingston
México=México D. F.
Nicaragua=Managua
Panamá=Panamá
Paraguay=Asunción
Perú=Lima
República Dominicana=Santo Domingo
San Cristóbal y Nieves=Basseterre
San Vicente y las Granadinas=Kingstown
Santa Lucía=Castries
Surinam=Paramaribo
Trinidad y Tobago=Puerto España
Uruguay=Montevideo
Venezuela=Caracas
Puerto Rico=San Juan

[Asia]
Afganistán=Kabul
Arabia Saudí=Riad
Armenia=Ereván
Azerbaiyán=Bakú
Bahréin=Manama
Bangladés=Dacca
Brunéi Darussalam=Bandar Seri Begawan
Bután=Timbu
Camboya=Phnom Penh
China=Pekín
Chipre=Nicosia
Corea del Norte=Pyongyang
Corea del Sur=Seúl
Emiratos Árabes Unidos=Abu Dabi
Filipinas=Manila
Georgia=Tiflis
India=Nueva Delhi
Indonesia=Yakarta
Iraq=Bagdag
(Irak)
Irán=Teherán
Israel=Jerusalén
(Israel -> Tel Aviv?)
(Palestina?)
Japón=Tokio
Jordania=Ammán
Kazajistán=Astaná
Kirguistán=Biskek
Kuwait=Kuwait
Laos=Vientián
Líbano=Beirut
Malasia=Kuala Lumpur
Maldivas=Malé
Mongolia=Ulán Bator
Myanmar=Yangon
(Birmania -> Rangún)
Nepal=Katmandú
Omán=Mascate
Pakistán=Islamabad
Qatar=Doha
Singapur=Singapur
Siria=Damasco
Sri Lanka=Colombo
Tailandia=Bangkok
(Taiwan -> Taipei)
Tayikistán=Dusambé
Turkmenistán=Asjabad
Uzbekistán=Taskent
Vietnam=Hanói
Yemen=Saná
Timor Oriental=Dili

[África]
Angola=Luanda
Argelia=Argel
Benín=Porto Novo
Botsuana=Gaborone
Burkina Faso=Uagadugú
Burundi=Buyumbura
Cabo Verde=Praia
Camerún=Yaundé
República Centroafricana=Bangui
Chad=Yamena
Comoras=Moroni
El Congo=Brazaville
República Democrática del Congo=Kinshasa
Costa de Marfil=Yamusukro
Yibuti=Yibuti
Egipto=El Cairo
Eritrea=Asmara
Etiopía=Adís Abeba
Gabón=Libreville
Gambia=Banjul
Ghana=Accra
Guinea-Bissau=Bissau
Guinea=Conakry
Guinea Ecuatorial=Malabo
Kenia=Nairobi
Lesoto=Maseru
Liberia=Monrovia
Libia=Trípoli
Madagascar=Antananarivo
Malaui=Lilongüe
Mali=Bamako
(Malí)
Marruecos=Rabat
Mauricio=Port-Louis
Mauritania=Nuakchot
Mozambique=Maputo
Namibia=Windhoek
Níger=Niamey
Nigeria=Abuya
Ruanda=Kigali
Santo Tomé y Príncipe=Santo Tomé
Senegal=Dakar
Seychelles=Victoria
Sierra Leona=Freetown
Somalia=Mogadiscio
Sudáfrica=Pretoria
(Bloemfontein, Ciudad del Cabo y Pretoria)
Sudán=Jartum
Suazilandia=Mbabane
(Mbabane y Lobamba)
Tanzania=Dodoma
(Tanzania -> Daar es Salaam)
Togo=Lomé
Túnez=Túnez
Uganda=Kampala
Zambia=Lusaka
Zimbabue=Harare
(Sahara)

[Oceanía]
Australia=Camberra
(Canberra)
Fiyi=Suva
Kiribati=Bairiki
Islas Marshall=Majuro
Micronesia=Palikir
Nauru=Yaren
Nueva Zelanda=Wellington
Palaos=Koror
Papúa Nueva Guinea=Port Moresby
Islas Salomón=Honiara
Samoa=Apia
Tonga=Nuku'alofa
Tuvalu=Fongafale
Vanuatu=Port Vila
Islas Cook=Avarua

